##########################
#                        #
#     $                  P
#                        #
#                     $  #
#                        #
#  !!!!                  #
##########################


#: Pared	P: Puerta
$: Cofre
!: Almas