##########################
#               *        #
#     $                  P
#          *             #
#                     $  #
#                        #
#  !!!!                  #
##########################


#: Pared	P: Puerta
$: Cofre
*: trampa
!: Almas